20  20  20  20  20  20  20  20  20  20  20  20  20  20  20  20  20  20  20  20  20  22  22  22  22  22  22  22  22  22  22  22  22  22  22  22  22  22  22  22  22  22  22  22  22  22  22  22  22  22  22  22  22  22  22  22  22  22  22  22  22  22  22  22  22  22  22  22  22  22  22  22  22  22  22  22  22  22  22  22  22  22  22  22  22  22  22  20  20  20  20  20  20  20  20  20  20  20  20 20
20 -1  -1  -1  -1  -1  -1  -1  -1  -1  -1  -1  -1  -1  -1  -1   21 -1  -1  -1  -1  -1  -1  -1   24 -1  -1  -1  -1  -1  -1  -1  -1  -1  -1  -1  -1   24 -1  -1  -1  -1  -1   24 -1   23 -1  -1  -1  -1  -1   23 -1  -1  -1  -1  -1   23 -1  -1  -1   23 -1  -1   23 -1  -1  -1  -1  -1  -1  -1  -1  -1  -1  -1  -1  -1  -1  -1  -1  -1  -1  -1  -1  -1   24 -1  -1  -1  -1   20  20 -1  -1  -1  -1   20  20 20
20 -1  -1  -1  -1  -1  -1  -1  -1  -1  -1  -1  -1  -1  -1  -1   21 -1  -1  -1  -1  -1  -1  -1   24 -1  -1  -1  -1  -1  -1  -1  -1  -1  -1  -1  -1   24 -1  -1  -1  -1  -1   24 -1   23 -1  -1  -1  -1  -1   23 -1  -1  -1  -1  -1   23 -1  -1  -1   23 -1  -1  -1  -1  -1   23 -1   23 -1  -1  -1   24 -1  -1  -1  -1  -1  -1  -1  -1   24 -1  -1   24  24 -1  -1  -1  -1  -1  -1   21 -1  -1   21 -1   20 20
20 -1  -1  -1  -1  -1  -1  -1  -1  -1  -1  -1  -1  -1  -1  -1   21 -1  -1  -1  -1  -1  -1  -1   24 -1  -1  -1  -1  -1  -1  -1  -1  -1   24 -1  -1   24 -1  -1   24  24 -1   24 -1   23 -1  -1   23 -1  -1   23 -1  -1   23 -1  -1   23 -1  -1  -1   23 -1  -1  -1   23 -1  -1  -1  -1   24 -1   24 -1  -1  -1   24  24  24 -1  -1  -1   24 -1  -1   24 -1  -1  -1  -1  -1  -1  -1  -1  -1  -1  -1  -1  -1  20
20 -1  -1   21  21  21  21  21  21  21  21  21  21 -1  -1  -1   21 -1  -1  -1  -1  -1  -1  -1   24 -1  -1  -1  -1  -1  -1  -1  -1  -1   24 -1  -1   24 -1   24 -1  -1  -1   24 -1   23 -1  -1   23 -1  -1   23 -1  -1   23 -1  -1   23 -1   23  23  23 -1   23 -1  -1  -1  -1  -1  -1  -1  -1  -1  -1  -1  -1  -1  -1  -1  -1  -1  -1   24 -1   24 -1  -1  -1  -1  -1  -1  -1   21 -1  -1  -1  -1  -1  -1  20
20 -1  -1   21 -1  -1  -1  -1  -1  -1  -1  -1  -1  -1  -1  -1  -1  -1  -1  -1  -1  -1  -1  -1   24 -1  -1  -1  -1   24  24  24 -1  -1   24  24  24  24 -1   24 -1  -1  -1   24 -1   23 -1  -1   23 -1  -1   23 -1  -1   23 -1  -1   23 -1  -1  -1  -1  -1  -1  -1  -1   23 -1   23 -1   24 -1  -1   24 -1   24 -1  -1  -1   24 -1  -1  -1   24  24 -1  -1  -1  -1  -1  -1  -1  -1   23 -1   21 -1   21 -1  20
20 -1  -1   21 -1  -1  -1  -1  -1  -1  -1  -1  -1  -1  -1  -1  -1  -1  -1  -1  -1  -1  -1   24 -1  -1  -1  -1   24 -1  -1  -1  -1  -1  -1  -1  -1   24 -1   24 -1  -1  -1   24 -1   23 -1  -1   23 -1  -1  -1  -1  -1   23 -1  -1   23 -1  -1  -1  -1  -1  -1  -1   23 -1  -1  -1  -1  -1  -1  -1  -1  -1  -1  -1  -1  -1  -1  -1  -1  -1   24 -1  -1  -1  -1  -1  -1   23 -1  -1   23 -1  -1  -1  -1  -1  20
20 -1  -1   21 -1  -1  -1  -1  -1  -1  -1  -1  -1  -1  -1  -1  -1  -1  -1  -1  -1  -1  -1   24 -1  -1  -1   24 -1  -1  -1  -1  -1  -1  -1  -1  -1   24 -1  -1   24  24  24  24 -1   23 -1  -1   23 -1  -1  -1  -1  -1   23 -1  -1   23 -1  -1  -1  -1   23 -1  -1  -1  -1  -1   23 -1  -1   23 -1  -1  -1  -1  -1  -1  -1  -1  -1  -1   24 -1  -1  -1  -1  -1  -1  -1  -1  -1  -1  -1  -1  -1  -1  -1  -1  20
20 -1  -1  -1  -1  -1  -1  -1  -1  -1  -1  -1  -1  -1  -1  -1  -1  -1  -1  -1  -1  -1  -1   24 -1  -1  -1   24 -1  -1  -1  -1  -1  -1  -1  -1  -1   24 -1  -1  -1  -1  -1  -1  -1   23 -1  -1   23  23  23  23  23  23  23  23  23  23 -1  -1  -1  -1  -1  -1  -1  -1  -1   23 -1  -1  -1  -1  -1  -1  -1  -1  -1  -1  -1  -1  -1  -1  -1  -1  -1  -1  -1  -1  -1  -1  -1  -1   21 -1  -1  -1  -1  -1  -1  20
20 -1  -1  -1  -1  -1   21  21  21  21  21  21  21  21 -1  -1  -1  -1  -1  -1  -1  -1   24 -1  -1  -1   24 -1  -1  -1  -1  -1  -1  -1  -1  -1  -1   24 -1  -1  -1  -1  -1  -1  -1  -1  -1  -1  -1  -1  -1  -1  -1  -1  -1  -1   23 -1  -1  -1  -1  -1  -1   23 -1   23 -1  -1  -1   24 -1  -1   24 -1  -1  -1   24 -1  -1   24 -1  -1  -1   24 -1  -1  -1  -1  -1  -1  -1  -1  -1  -1  -1  -1  -1  -1  -1  20
20 -1  -1  -1  -1  -1   21 -1  -1  -1  -1  -1  -1  -1  -1  -1  -1  -1  -1  -1  -1   24 -1  -1  -1   24 -1  -1  -1  -1  -1  -1  -1  -1  -1  -1  -1   24 -1  -1  -1  -1  -1  -1  -1  -1  -1  -1  -1  -1  -1  -1  -1  -1  -1  -1   23 -1  -1  -1   23 -1  -1  -1  -1  -1  -1  -1   23 -1  -1   24 -1  -1  -1  -1  -1  -1  -1  -1  -1  -1   24 -1  -1  -1  -1  -1  -1  -1   23 -1  -1  -1   21 -1  -1  -1  -1  20
20 -1  -1   26 -1  -1   21 -1  -1  -1  -1  -1  -1  -1  -1  -1  -1  -1  -1  -1  -1  -1  -1  -1  -1  -1  -1  -1  -1  -1  -1  -1  -1   24  24 -1  -1   24 -1  -1  -1  -1  -1  -1  -1  -1  -1  -1  -1  -1  -1  -1  -1  -1  -1  -1   23 -1  -1  -1   23 -1   23 -1  -1  -1   23 -1  -1  -1  -1  -1  -1  -1   24 -1  -1  -1  -1  -1  -1  -1   24  24 -1  -1  -1  -1  -1  -1  -1  -1   21 -1  -1  -1  -1   25 -1  20
20 -1  -1  -1  -1  -1   21 -1  -1  -1  -1  -1  -1   21 -1  -1  -1  -1  -1  -1  -1  -1  -1  -1  -1  -1  -1  -1  -1  -1  -1  -1   24 -1  -1  -1  -1  -1  -1  -1  -1  -1  -1  -1  -1  -1   23 -1  -1   23 -1  -1  -1  -1  -1   23 -1  -1  -1   23 -1  -1  -1  -1   23 -1  -1  -1  -1   24 -1  -1  -1  -1  -1  -1  -1  -1  -1   24 -1  -1  -1   24 -1  -1  -1  -1  -1  -1  -1  -1  -1  -1  -1  -1  -1  -1  -1  20
20 -1  -1  -1  -1  -1   21 -1  -1   21 -1  -1  -1   21 -1  -1  -1  -1  -1  -1  -1  -1  -1  -1  -1  -1  -1  -1  -1  -1  -1   24 -1  -1  -1  -1  -1  -1  -1  -1  -1  -1  -1  -1  -1  -1  -1   23 -1  -1   23 -1  -1  -1  -1   23 -1  -1  -1   23 -1  -1  -1  -1  -1  -1  -1  -1   23 -1  -1  -1  -1  -1  -1  -1  -1  -1  -1  -1  -1  -1   24  24 -1  -1  -1  -1  -1  -1  -1  -1  -1  -1  -1  -1  -1  -1  -1  20
20 -1  -1  -1  -1  -1   21 -1  -1   21 -1  -1  -1   21 -1  -1  -1  -1  -1  -1  -1   24  24  24  24  24  24 -1  -1  -1   24 -1  -1  -1  -1  -1  -1  -1  -1  -1  -1  -1  -1  -1  -1  -1  -1  -1   23 -1  -1   23  23  23  23 -1  -1  -1  -1   23 -1  -1  -1   23 -1   23 -1  -1  -1  -1  -1  -1   24 -1  -1  -1  -1  -1  -1  -1  -1  -1   24 -1  -1  -1  -1  -1  -1  -1   23 -1   21 -1  -1  -1  -1  -1  -1  20
20 -1  -1  -1  -1  -1   21 -1  -1   21 -1  -1  -1   21 -1  -1  -1  -1  -1  -1  -1  -1  -1  -1  -1  -1   24 -1  -1  -1   24 -1  -1  -1  -1  -1  -1  -1  -1  -1  -1  -1  -1  -1  -1  -1  -1   23 -1  -1   23 -1  -1  -1  -1  -1  -1  -1  -1   23 -1  -1  -1   23 -1  -1  -1   23 -1  -1   23 -1  -1  -1   24 -1  -1  -1   24 -1  -1  -1   24  24 -1  -1  -1  -1  -1  -1  -1  -1  -1  -1   23 -1   21 -1  -1  20
20 -1  -1  -1  -1  -1   21 -1  -1   21 -1  -1  -1   21 -1  -1  -1  -1  -1  -1  -1  -1  -1  -1  -1  -1   24 -1  -1  -1   24 -1  -1  -1   24  24  24  24  24  24 -1  -1  -1  -1  -1  -1   23 -1  -1   23 -1  -1  -1  -1  -1  -1  -1  -1   23 -1  -1   23 -1  -1   23 -1  -1  -1   23 -1   24 -1  -1  -1  -1  -1  -1  -1  -1  -1  -1  -1  -1   24 -1  -1  -1  -1  -1  -1  -1  -1  -1  -1  -1  -1  -1  -1  -1  20
20 -1  -1   21  21  21  21 -1  -1   21  21  21  21  21 -1  -1  -1  -1  -1  -1  -1   24 -1  -1  -1  -1   24 -1  -1  -1   24 -1  -1  -1  -1  -1  -1  -1  -1  -1  -1  -1  -1  -1  -1  -1   23 -1  -1   23 -1  -1  -1  -1  -1  -1  -1   23 -1  -1  -1  -1  -1  -1  -1  -1   23 -1  -1  -1  -1   24 -1  -1  -1  -1   24 -1  -1  -1  -1  -1   24  24 -1  -1  -1  -1  -1  -1  -1  -1   21 -1  -1  -1  -1  -1  -1  20
20 -1  -1  -1  -1  -1  -1  -1  -1  -1  -1  -1  -1  -1  -1  -1  -1  -1  -1  -1  -1   24 -1  -1  -1  -1   24 -1  -1  -1   24 -1  -1  -1  -1  -1  -1  -1  -1  -1  -1  -1  -1  -1  -1  -1   23 -1  -1  -1  -1  -1   23  23  23  23  23 -1  -1   23 -1  -1  -1   23 -1   23 -1  -1  -1  -1  -1  -1  -1   24 -1  -1  -1  -1  -1  -1  -1  -1  -1   24 -1  -1  -1  -1  -1  -1  -1  -1  -1  -1   21 -1  -1  -1  -1  20
20 -1  -1  -1  -1  -1  -1  -1  -1  -1  -1  -1  -1  -1  -1  -1  -1  -1  -1  -1  -1  -1  -1  -1  -1  -1   24 -1  -1  -1   24 -1  -1  -1  -1  -1  -1  -1  -1  -1  -1  -1  -1  -1  -1  -1   23 -1  -1  -1  -1   23 -1  -1  -1  -1  -1  -1  -1  -1  -1  -1  -1  -1  -1  -1  -1  -1   23 -1  -1   23 -1  -1  -1  -1  -1   24 -1  -1  -1  -1   24 -1  -1  -1  -1  -1  -1  -1   20 -1  -1   21 -1  -1   21 -1   20 20
20 -1  -1  -1  -1  -1  -1  -1  -1  -1  -1  -1  -1  -1  -1  -1  -1  -1  -1  -1  -1  -1  -1  -1  -1  -1  -1  -1  -1  -1   24 -1  -1  -1  -1  -1  -1  -1  -1  -1  -1  -1  -1  -1  -1  -1   23 -1  -1  -1  -1   23 -1  -1  -1  -1   23 -1  -1  -1  -1  -1   23 -1   23 -1   23 -1  -1  -1   24 -1  -1  -1  -1  -1  -1  -1  -1   24 -1   24 -1  -1  -1  -1  -1  -1  -1   20  20  20 -1  -1  -1  -1  -1   20  20 20
20  20  20  20  20  20  20  20  20  20  20  20  20  20  20  20  20  20  20  20  20  22  22  22  22  22  22  22  22  22  22  22  22  22  22  22  22  22  22  22  22  22  22  22  22  22  22  22  22  22  22  22  22  22  22  22  22  22  22  22  22  22  22  22  22  22  22  22  22  22  22  22  22  22  22  22  22  22  22  22  22  22  22  22  22  22  22  20  20  20  20  20  20  20  20  20  20  20  20 20
