20 20 20 20 20 20 20 20 20 20 20 20 20 20 20 20 20 20 20 20 20 20 20 20 20 20 20 20 20 20 20 20 5 5 5 5 5 5 5 5 5 5 5 5 5 5 5 5 5 5 5 5 5 5 5 5 5 5 5 5 5 5 5 5
20 20 20 20 20 20 20 20 20 20 20 20 20 20 20 20 20 20 20 20 20 20 20 20 20 20 20 20 20 20 20 20 5 5 5 5 5 5 5 5 5 5 5 5 5 5 5 5 5 5 5 5 5 5 5 5 5 5 5 5 5 5 5 5
20 20 20 20 20 20 20 20 20 20 20 20 20 20 20 20 20 20 20 20 20 20 20 20 20 20 20 20 20 20 20 20 5 5 5 5 5 5 5 5 5 5 5 5 5 5 5 5 5 5 5 5 5 5 5 5 5 5 5 5 5 5 5 5
20 20 20 20 20 20 20 20 20 20 20 20 20 20 20 20 20 20 20 20 20 20 20 20 20 20 20 20 20 20 20 20 5 5 5 5 5 5 5 5 5 5 5 5 5 5 5 5 5 5 5 5 5 5 5 5 5 5 5 5 5 5 5 5
20 20 20 20 20 20 20 20 20 20 20 20 20 20 20 20 20 20 20 20 20 20 20 20 20 20 20 20 20 20 20 20 22 22 22 22 22 22 22 22 22 22 22 22 22 22 22 22 22 22 22 22 22 22 22 22 22 22 22 22 22 22 22 22
20 20 20 20 20 20 20 20 20 20 20 20 20 20 20 20 21 21 21 21 21 21 0 0 0 0 0 0 0 0 0 1 5 5 5 5 5 5 5 5 5 5 5 5 5 5 5 9 7 7 7 7 7 7 7 7 7 11 5 5 5 5 3 13 13
20 20 20 20 20 20 20 20 20 20 20 20 20 20 20 20 21 0 0 0 0 21 0 0 0 0 0 0 0 0 0 1 5 5 5 5 5 5 5 5 5 5 5 5 5 5 5 9 7 7 7 7 7 7 7 7 7 11 5 5 5 5 3 13 13
20 20 20 20 20 20 20 20 20 20 20 20 20 20 20 20 21 0 0 0 0 21 0 0 0 0 0 0 0 0 0 1 5 5 5 5 5 5 5 5 5 5 5 5 5 5 5 9 7 7 7 7 7 7 7 7 7 11 5 5 5 5 3 13 13
20 20 20 20 20 20 20 20 20 20 20 20 20 20 20 20 21 0 0 0 0 21 0 0 0 0 0 0 0 0 0 1 5 5 5 5 5 5 5 5 5 5 5 5 5 5 5 9 7 7 7 7 7 7 7 7 7 11 5 5 5 5 3 13 13
20 20 20 20 20 20 20 20 20 20 20 20 20 20 20 20 21 0 21 0 0 21 21 21 21 0 0 0 0 0 0 1 5 5 5 5 5 5 5 5 5 5 5 5 5 5 5 9 7 7 7 7 7 7 7 7 7 11 5 5 5 5 3 13 13
20 20 20 20 20 20 20 20 20 20 20 20 20 20 20 20 0 0 21 21 0 0 0 0 0 0 0 0 0 0 0 1 5 5 5 5 5 5 5 5 5 5 5 5 5 5 5 9 7 7 7 7 7 7 7 7 7 11 5 5 5 5 3 13 13
20 20 20 20 20 20 20 20 20 20 20 20 20 20 20 20 21 0 0 21 0 0 0 0 0 0 0 0 0 0 0 1 5 5 5 5 5 5 5 5 5 5 5 5 5 5 5 9 7 7 7 7 7 7 7 7 7 11 5 5 5 5 3 13 13 
20 20 20 20 20 20 20 20 20 20 20 20 20 20 20 20 21 0 0 21 0 0 0 0 0 0 0 0 0 0 0 1 5 5 5 5 5 5 5 5 5 5 5 5 5 5 5 9 7 7 7 7 7 7 7 7 7 11 5 5 5 5 3 13 13
20 20 20 20 20 20 20 20 20 20 20 20 20 20 20 20 21 0 0 21 21 21 21 0 0 0 0 0 0 0 0 1 5 5 5 5 5 5 5 5 5 5 5 5 5 5 5 9 7 7 7 7 7 7 7 7 7 11 5 5 5 5 3 13 13
20 20 20 20 20 20 20 20 20 20 20 20 20 20 20 20 21 0 0 0 0 0 0 0 0 0 0 0 0 0 0 1 5 5 5 5 5 5 5 5 5 5 5 5 5 5 5 9 7 7 7 7 7 7 7 7 7 11 5 5 5 5 3 13 13
20 20 20 20 20 20 20 20 20 20 20 20 20 20 20 20 21 0 0 0 0 0 0 0 0 0 0 0 0 0 0 1 5 5 5 5 5 5 5 5 5 5 5 5 5 5 5 9 7 7 7 7 7 7 7 7 7 11 5 5 5 5 3 13 13
20 20 20 20 20 20 20 20 20 20 20 20 20 20 20 20 21 21 21 21 21 0 0 0 0 0 0 0 0 0 0 1 5 5 5 5 5 5 5 5 5 5 5 5 5 5 5 9 7 7 7 7 7 7 7 7 7 11 5 5 5 5 3 13 13
20 20 20 20 20 20 20 20 20 20 20 20 20 20 20 20 20 20 20 20 20 20 20 20 20 20 20 20 20 20 20 20 22 22 22 22 22 22 22 22 22 22 22 22 22 22 22 22 22 22 22 22 22 22 22 22 22 22 22 22 22 22 22 22
20 20 20 20 20 20 20 20 20 20 20 20 20 20 20 20 20 20 20 20 20 20 20 20 20 20 20 20 20 20 20 20 5 5 5 5 5 5 5 5 5 5 5 5 5 5 5 5 5 5 5 5 5 5 5 5 5 5 5 5 5 5 5 5
20 20 20 20 20 20 20 20 20 20 20 20 20 20 20 20 20 20 20 20 20 20 20 20 20 20 20 20 20 20 20 20 5 5 5 5 5 5 5 5 5 5 5 5 5 5 5 5 5 5 5 5 5 5 5 5 5 5 5 5 5 5 5 5
20 20 20 20 20 20 20 20 20 20 20 20 20 20 20 20 20 20 20 20 20 20 20 20 20 20 20 20 20 20 20 20 5 5 5 5 5 5 5 5 5 5 5 5 5 5 5 5 5 5 5 5 5 5 5 5 5 5 5 5 5 5 5 5
20 20 20 20 20 20 20 20 20 20 20 20 20 20 20 20 20 20 20 20 20 20 20 20 20 20 20 20 20 20 20 20 5 5 5 5 5 5 5 5 5 5 5 5 5 5 5 5 5 5 5 5 5 5 5 5 5 5 5 5 5 5 5 5
